11111111111111111111111
1100000C001100011100001
100C000P000000000C01001
111000C11000000001110E1
11111111111111111111111